20
2 2 2 2 2 2 2 1 2 3 2 2 2 2 2 2 2 1 2 3
2 3 5 5 5 5 5 6 2 1 2 3 5 5 5 5 5 6 2 1
6 5 5 2 1 2 2 2 2 2 6 5 5 2 1 2 2 2 2 2
2 2 1 2 3 2 3 5 5 5 2 2 1 2 3 2 3 5 5 5
5 5 6 2 1 6 5 5 2 1 5 5 6 2 1 6 5 5 2 1
2 2 2 2 2 2 2 1 2 3 2 2 2 2 2 2 2 1 2 3
2 3 5 5 5 5 5 6 2 1 2 3 5 5 5 5 5 6 2 1
6 5 5 2 10 2 2 2 2 2 6 5 5 2 10 2 2 2 2 2
2 2 1 2 3 2 3 5 5 5 2 2 1 2 3 2 3 5 5 5
5 5 6 2 1 6 5 5 2 1 5 5 6 2 1 6 5 5 2 1
2 2 2 2 2 2 2 1 2 3 2 2 2 2 2 2 2 1 2 3
2 3 5 5 5 5 5 6 2 1 2 3 5 5 5 5 5 6 2 1
6 5 5 2 1 2 2 2 2 2 6 5 5 2 1 2 2 2 2 2
2 2 1 2 3 2 3 5 5 5 2 2 1 2 3 2 3 5 5 5
5 5 6 2 1 6 5 5 2 1 5 5 6 2 1 6 5 5 2 1
2 2 2 2 2 2 2 1 2 3 2 2 2 2 2 2 2 1 2 3
2 3 5 5 5 5 5 6 2 1 2 3 5 5 5 5 5 6 2 1
6 5 5 2 10 2 2 2 2 2 6 5 5 2 10 2 2 2 2 2
2 2 1 2 3 2 3 5 5 5 2 2 1 2 3 2 3 5 5 5
5 5 6 2 1 6 5 5 2 1 5 5 6 2 1 6 5 5 2 1